++++++++++++++++++++++++++++++++++++++++++++++++++++++
+                                                    +
+0   A                                               +
+  a                                                 +
+                                                    +
+                                                    +
+                                                    +
+                                                    +
+                                                    +
+                                                    +
+                                                    +
+                                                    +
+                                                    +
+                                                    +
+                                                    +
+                                                    +
+                                                    +
+                                                    +
+                                                    +
+                                                    +
+                                                    +
+                                                    +
+                                                    +
+                                                    +
+                                                    +
++++++++++++++++++++++++++++++++++++++++++++++++++++++
