++++++++++++++++++++
+            A A   +
+     0      A A   +
+            A A   +
+            A A   +
+            A A  a+
++++++++++++++++++++
